stroke      |гладить, успокаивать, задавать такт; удар, ход поршня
kikc        |удар ногой, пинок
strenght    |сильный, сила, достоинство, сильная сторона
waste       |растрата,расточительсов,, П.ненужный, бракованный, Г.терять даром/впустую
bend        |сгибать, поворачиваться
hip         |бедро
axis        |ось, осевая линия
counteract  |противодействовать, нейтрализовать
literally   |буквально, дословно
degree      |уровень, степень
identify    |определять, отождествлять, опозновать
folde       |складывать
folded      |сложенный
convey      |передавать, переправлять, сообщать
	convey      |передавать(звук,запах.инфекцию), сообщать, выразить
simply put  |проще говоря
	simply put	|проще говоря
simplicity	|простота(ease),доступность(accessibility),легость
encourage   |поощерять, поддерживать, одобрять
adhere      |придерживаться, оставаться верным (чему-либо)
span        |охватывать
	span	|C.интервал/диапазон, промежуток времени;Г.охватывать,перекрывать,простираться [spæn] 
genuinely   |искренне, неподдельно
empathy     |сочувствие, сопережевание
tight       |плотный, тесный, узкий,,плотно, крепко
charge      |заряжать,, обвинять(accuse),, поручать(instruct),, обвинение(accusation)
counterpart |копия, аналог,, коллега, партнер
worth       |С.ценность,значимость,,стоящий,достойный,,Г.случаться,происходить,становиться [wɜ:θ]
	worth/valuable	|ценность,стоимость;стоящий,достойный [wɜ:θ]
acquainted  |знакомый, знающий, информированный
acquaint 	|знакомить с (чем либо), ознакомляться с (чем либо) [ə'kweɪnt]
despite     |несмотря на, вопреки,, злоба, презрение
cluter      |беспорядок, хаос, бардак
curcumstance|обстаятельства, случай, условие,,положение дел
govern      |править, управлять, руководить
	govern		|править, управлять,руковдить;средживать,ограничивать.
swallow     |глатать, глотка
budget      |бюджет, смета
drained     |Г.истощать, исчерпывать;Прич.высохший,осушенный
thenderlion |вырезка, фелей
dry         |сухой
dray        |лом
as 			|Пред.в качестве,как;Н.одинаково,в ровной степени;Мест.какой,который,что;Союз.Таким образом, так как, также как и
thought     |мысль, мышление,, намерение, цель,, забота, внимание
though      |хотя, не смотря на
as though   |как будто
even though |даже если, хотя, даже не смотря на
though		|однако, хотя, не смотря на, хоть и
		though		|Союз.хотя,впрочем, если бы, пусть;Н.однако, несмотря на
although	|несмотря на то(while),однако(but); хотя(though);
		although hardly |хотя вряд ли
circuit     |схема (эл)
foremost    |в первую очередь, преждве всего,, во-первых (frist at all)
complement  |дополнение, полнота, совокупность,, дополнять, составлять
by leaps and bound  |очень быстро
make use of |использовать
employ      |использовать, применять, употреблять
tale advantage of |воспользоваться
when it comes to    |когда дело доходит до
harness     |запрягать, впрягать,, упряжь
anxious     |тревожный, стремящийся, сильно желающий
drive right on |погрузиться прямо в
?cross-cuttring  |сквозной
refine      |очищать, удалять, корректировать, оптимизировать
nutshell    |в 2х словах, короче говоря
examine     |рассматривать, осматривать, исслепдовать, изучать, допрашивать в суде
eager       |П.немедленный, безотлагательный, жаждующий ['i:gə]
	eager		|жаждующий, нетерпеливый
outcome     |С.результат,исход,итог ['autkʌm]
	outcome	|результат
seal        |Г.запечатывать,заклеивать,замазывать;С.печать,пломба
tuition     |Г.обучение, плата за обучение (tuition fee - плата за обучение) [tju:'ɪʃ(ə)n]
bar			|Г.запрещать;преграждать,загораживать (bars the money from going to - запрещает поступление денег)
court       |С.суд,судебное заседание;двор(yard),корт,площадка;Г.ухаживать(care) [kɔːt] 
jistice     |C.справедливоcть, законность;правосудие;судья [ˈʤʌstɪs]
dismantle   |демонтировать, разбирать,,раздевать, срывать
pluck       |срывать, ощипывать, щипать; дерганье, рывок
fought      |драться
treatment   |обращение, обработка; трактовка, рассмотрение, толкование; лечение
treat       |удовольствие, наслождение; угощение, лакомство, вкусняшки
tasty       |вкусный
precisely   |определенно, чётко, именно, вточности
precise     |определенный, точный, ясный
merely      |просто
abbreviated |сокращенный, укороченный
abbreviate  |сокращать, урезать (текст); делать выдержки (из документа)
run up against sth  |сталкиваться с чем либо (с трудностями)
hold sth against sb |ставить что-либо в вину кому-либо
react against sth   |оказывать сопротивление чему-либо
guard against sth   |ограждать, защищать
go against sth      |противоречть, нарушать
go against sb       |быть не в чью пользоу
Once in a while     |время от времени

gather  |сбор, собирать, приобретать, увеличивать;делать выводы, приходить к заключению ['gæðə]
rather  |скорее, наоборот, точнее, правильнее; лучше, предпочтительнее; довльно, весьма, достаточно

may take a while on |может занять некоторое время
couple of time  |пару раз
succeed     |преуспеть, достигать цели